there might be = pode ser que haja
try on         = experimentar
to expensives  = caros demais
on sale        = em promoção
salesperson    = vendedor
has been       = está
worried about  = preocupado com
lie down       = se deitar
Could I get    = vocẽ poderia me trazer
We're going    = Nós vamos 
look after     = cuidar
We enjoyed ourselves = Nós nos divertimos
my regular dentist = meu dentista habituial
guess what = adivinha só
that's a shame = É uma pena
OK, I'm ready! = Certo, eu estou pronta!
Walk to the supermarket and turn left = Ande até o supermercado e vire à esquerda.
The bus is turning right = O ônibus está virando à direita.
Go to the end of the street = Vá até o fim da rua.
The bookstore isn't on this street = A livraria não é nesta rua.
Ela precisa virar à esquerda = She needs to turn left.
She's not ready to go = Ela não está pronta para ir.
The bus is turning right = O ônibus está virando à direita.
Turn right here = Vire à direita aqui.
Can I walk to the bookstore from here? = Eu posso andar até a livraria daqui?
# Verbos Infinitivos 2
Do you want me to stay here with you? = Você quer que eu fique aqui com você?
I am too tired to continue = Eu estou cansado demais para continar
She can not continue here = Ela não pode continuar aqui
We want to continue drinking coffee = Nós queremos continuar bebendo café
They need to apply = Elas precisam se candidatar
The traffic in the city does not stop = O tráfego da cidade não para
We need to build a house = Nós precisamos construir uma casa
I want to stay here = Eu quero ficar aqui
I want to leave my purse at home = Eu quero deixar minha bolsa em casa
They need to apply = Eles precisam se candidatar
I hope to build a new house next year = Eu quero construir uma casa nova ano que vem
You do not believe me = Você não acredita em mim
I want to stop drinking wine = Eu quero para de beber vinho
He was happy to leave = Ele estava feliz em ir embora
I want to believe = Eu quero acreditar
We need to build a house = Nós precisamos construir uma casa
She decided to leave her job = Ela decidiu deixar seu trabalho
The engineer used to stop by the bar after work = O engenheiro costumava passar pelo bar depois do trabalho
Do you want me to stay here with you? = Você quer que eu fique aqui com você?
In order to apply, you have to go in person = Para se candidatar, você temque ir pessoalmente
I am not sorry for my acts = Eu não lamento pelos meus atos
He explains his act = Ele explica o seu ato
They used the equipment to make cheese = Eles usaram o equipamento para fazer queijo
He is out of control = Ele está fora de controle
There are five categories = Há cinco categorias
The equipment = The equipamento
I am in the same category = Eu estou na mesma categoria
I like this image = Eu gosto desta imagem
What is the profile of the students? = Qual é o perfil dos estudantes?
Here is a little description = Aqui está uma pequena descrição
We had things under control = Nós tivemos as coisas sob controle
Do you know of anyone who fits this description? = você conhece alguém com essa descrição?
They talk about a different category = Eles falam sobre uma categoria diferente
The content of the book is not for children = O conteúdo do livro não é para crianças
How do I add images to my page? = Como eu adiciono imagens à minha página?
There are five categories = Há cinco categorias
What is the value of that house? = Qual é o valor daquela casa?
The son creates a profile for his mother = O filho cria um perfil para sua mãe
What is exactly its value? = Qual é exatamente o valor dele?

